DEORN	DOOR
THE	THE
THT	THE
TRIPIS	TRIPLE
THE	THE
AURO	AUTO
MAGIC	MAGIC
BILLIARDS	BILLIARDS
FIRST	FIRST
SOUTH	SOUTH
MARNES	MARKET
MRAT	MEAT
INCMARRINM	MICHOACANA
TAAWERNA	TAQUERIA
TIQUERRLG	TAQUERIA
MOTIF	MOTIF
RESTAURANT	RESTAURANT
CLUB	CLUB
AND	AND
SUUTS	SOUTH
LURSL	FIRST
COLORADO	COLORADO
DAILY	DAILY
COLLEGE	COLLEGE
EVEREST	EVEREST
ALEN	ALLEN
HESS	HESS
CENTER	CENTER
JAPANESE	JAPANESE
RESTUURANT	RESTAURANT
SAKANA	SAKANA
UGEBOK	ICEBOX
TILLE	THE
CLAIRE	CLAIRE
SAINTE	SAINTE
THE	THE
MISSION	MISSION
WHEELER	WHEELER
GIFTS	GIFTS
JAS	JAS
PITZZAL	PIZZA
MIN	MAN
SOPRA	SOPRA
SOLTO	SOTTO
AIRWAYS	AIRWAYS
EANNLLEK	CENTER
CARROLL	CARROLL
STREET	STREET
INDLANA	INDIANA
IIPPRRTORY	REPERTORY
THENTRA	THEATRE
INDIANA	INDIANA
INN	INN
LOYAL	LOYAL
WESTERN	WESTERN
BEST	BEST
PARAMOUNT	PARAMOUNT
KFC	KFC
MUZZO	MUZEO
BUEEUIE	PUBLIC
ONNAEEIM	ANAHEIM
TRIDENT	TRIDENT
WINBRO	WINBRO
CRAHE	GRANT
OLIN	OLIN
BEST	BEST
EXECUTIVE	EXECUTIVE
INN	INN
WESTERN	WESTERN
DIEGO	DIEGO
EXCURSION	EXCURSION
HARBOR	HARBOR
SAN	SAN
CORTEL	CORTEZ
HOTET	HOTEL
HOTEL	HOTEL
MOORE	MOORE
MOORE	MOORE
HOTEL	HOTEL
WHIRCOMB	WHITCOMB
FUDRULTERS	FUDDRUCKERS
SIFFE	THE
QUIRMOS	QUIZNOS
QUIRMOS	QUIZNOS
MURPHY	MURPHY
MOON	MOON
PALACE	PALACE
COLORIAL	COLONIAL
HOBBY	HOBBY
INC	INC
PHOTO	PHOTO
PUFF	PUFF
SIIUIFF	STUFF
AECCHAEL	MICHAEL
SRIEE	ARTS
CRISEE	CRAFTS
TAED	WORLD
MANKET	MARKET
FITNESS	FITNESS
SHELT	SHELL
SOOUN	SHOGUN
SHOGUN	SHOGUN
SUSHI	SUSHI
SUIEN	SUSHI
PIONEER	PIONEER
PLACE	PLACE
SAKS	SAKS
FIFIH	FIFTH
AVENUE	AVENUE
GRAND	GRAND
HORTON	HORTON
HOTEL	HOTEL
LULA	ZULA
TAT	ZULA
HOTEL	HOTEL
LLON	LION
RID	RED
RAD	RED
SEUARE	SQUARE
BEAVEDERE	BELVEDERE
ORLANDO	ORLANDO
SENTINEL	SENTINEL
CLRCLES	CIRCLES
TOPES	TAPES
CITYARTS	CITYARTS
FACTORY	FACTORY
AAT	HUT
PIZA	PIZZA
CALACE	GARAGE
EYE	EYE
LOUNGE	LOUNGE
JOBSITE	JOBSITE
SUPPLY	SUPPLY
WORK	WORK
CHASE	CHASE
CHASEI	CHASE
FIREPLACE	FIREPLACE
BOX	BOX
JEWEL	JEWEL
TINY	TINY
NAPASORN	NAPASORN
PARE	PARC
HOREL	HOTEL
WARWICK	WARWICK
SCOOIERS	SCOOTERS
STONDICUE	SPORTIQUE
SPRUCE	SPRUCE
HEATL	HOTEL
WYNDHAM	WYNDHAM
JEROMS	JEROME
SCHOOL	SCHOOL
LESCRAFERS	LENSCRAFTERS
FIFTH	FIFTH
AVE	AVE
PIKE	PIKE
WESTERN	WESTERN
WINE	WINE
DOMINO	DOMINO
KYRO	KYRO
PIZZA	PIZZA
HIGH	HIGH
LINCOLN	LINCOLN
TCOOOL	SCHOOL
SCHOOL	SCHOOL
GANIOONIA	CALIFORNIA
EYES	EYES
FOR	FOR
SHFAI	SHEA
CHINESE	CHINESE
GADAT	GREAT
WALL	WALL
DRTIEB	ORTLIEB
PIPEEY	POLISH
SALLLE	SALLE
FORTUNE	FORTUNE
LUCKY	LUCKY
RESTAURANT	RESTAURANT
BRASSERIE	BRASSERIE
TEN	TEN
TFN	TEN
TEN	TEN
BOOT	BOOT
FITTING	FITTING
LARRY	LARRY
FOSSIL	FOSSIL
FOSSIL	FOSSIL
MARLL	MART
MOBIL	MOBIL
MOBLL	MOBIL
CINERAMA	CINERAMA
GINERAMA	CINERAMA
DONG	DONG
MARKET	MARKET
PENAAES	YMCA
BEADS	BEADS
BEADS	BEADS
BEADS	BEADS
FOX	FOX
CLEANERS	CLEANERS
HOREL	HOTEL
MAX	MAX
HALM	HAHM
MOTORMORTS	MOTORSPORTS
MOTORPOOTS	MOTORSPORTS
SOAIEY	HAHM
JOL	JOE
RKAABER	TRADER
BOOY	BODY
SHOP	SHOP
LINE	LINE
BUDGET	BUDGET
TRIBUNALL	TRIBUNALI
VIA	VIA
HUGELA	ANGELO
HAMBURGERS	HAMBURGERS
IX	FOX
GAMESIUY	GAMESTOP
FABRICS	FABRICS
FISHMAN	FISHMAN
BNC	INC
IIA	INC
FLATS	FLATS
TIJUANA	TIJUANA
LOL	ZOU
ZOU	ZOU
ZOU	ZOU
DODGE	DODGE
BTELES	PHELPS
TOWER	TOWER
ERNST	ERNST
YOUNC	YOUNG
SA	SAN
POMIPER	POMPEI
DONALD	DONALD
PONDLA	DONALD
RAMADA	RAMADA
CLEANERS	CLEANERS
FIVE	FIVE
STAC	STAR
GRANDSTAND	GRANDSTAND
CEALLUTANY	GRANDSTAND
ELGLLE	LITTLE
SAIGON	SAIGON
CAPITOL	CAPITOL
CUSTOM	CUSTOM
TAILORS	TAILORS
JEWELRY	JEWELRY
BAMPRTY	BAKERY
SETEECOIEE	WATERCOURSE
TOWN	TOWN
BLACK	BLACK
BOTTLE	BOTTLE
VINE	VINE
ECONO	ECONO
LODGE	LODGE
AVENUE	AVENUE
BEAAES	THEATER
CLEANERS	CLEANERS
CLEANERS	CLEANERS
GLENOAKS	GLENOAKS
ART	ART
JOSE	JOSE
MUSEUM	MUSEUM
SAN	SAN
DAVID	DAVID
JEAN	JEAN
LOUIS	LOUIS
MOSSER	MOSSER
THE	THE
CAFE	CAFE
MET	MET
NARTIOTS	MARRIOTT
SANDWICH	SANDWICH
SHOP	SHOP
ZERO	ZERO
HAPPINESS	HAPPINESS
THREE	THREE
CHNITOAN	CHINATOWN
PLAZA	PLAZA
SHELL	SHELL
TWO	TWO
MOBILE	MOBILE
NARRIATI	MARRIOTT
JUANOLL	MARRIOTT
HIGGINS	HIGGINS
BREXTON	BREXTON
CHASE	CHASE
HEALTH	HEALTH
SERVICES	SERVICES
INC	INC
FEET	FEET
SIX	SIX
UNDER	UNDER
ARMY	ARMY
STORE	STORE
FRANCIS	FRANCIS
HOSPTAL	HOSPITAL
MEMORIAL	MEMORIAL
SAINT	SAINT
CRUSH	CRUSH
FIRST	FIRST
MAGNOLIA	MAGNOLIA
OUNBAR	DUNBAR
HIAR	HIGH
LAURENCE	LAURENCE
PAUU	PAUL
SCHOOU	SCHOOL
ORLEANS	ORLEANS
ANODIZING	ANODIZING
INDUSTRIAL	INDUSTRIAL
DALLAS	DALLAS
SEMINARY	SEMINARY
THEGLOICAL	THEOLOGICAL
PUBLIC	PUBLIC
STORAGE	STORAGE
AMERICA	AMERICA
AMRRICA	AMERICA
BOOKS	BOOKS
AOONSE	BOOKS
FOR	FOR
RON	FOR
NIIT	MINT
BTATTS	STATES
UNITED	UNITED
CREST	CREST
PINE	PINE
RESTAURANT	RESTAURANT
GROEED	FORD
MILLS	MILLS
AVENUE	AVENUE
EIXTH	SIXTH
BAR	BAR
GRIEL	GRILL
AIXTH	SIXTH
GRIILL	GRILL
AYEAUE	AVENUE
BAR	BAR
RESTAURANI	RESTAURANT
STEWART	STEWART
FORUM	FORUM
FORUM	FORUM
HERITAGE	HERITAGE
HERITACE	HERITAGE
HIN	BAR
CLILL	GRILL
JOINT	JOINT
JUNE	JUKE
HOMEWOOD	HOMEWOOD
SUITES	SUITES
KITCHEN	KITCHEN
FALL	PARK
TAVERN	TAVERN
IIRRYE	TAVERN
WILLIAMS	WILLIAMS
UIINA	CHINA
DOLLAR	DOLLAR
INC	INC
TOWN	TOWN
DIIT	DING
CANEMA	CINEMA
SUB	SUB
CHURCH	CHURCH
FIRST	FIRST
METHODIST	METHODIST
UNLFED	UNITED
STARBUCKS	STARBUCKS
AE	STARBUCKS
COFFEE	COFFEE
CORRIS	COFFEE
CASBAH	CASBAH
RESTAURANT	RESTAURANT
TARA	TARA
BRASIL	BRAZIL
CANTO	CANTO
RESTAURANT	RESTAURANT
BICYCLE	BICYCLE
EXPRESS	EXPRESS
OOR	CAR
ENTERPRISE	ENTERPRISE
CEEPIEE	ENTERPRISE
RONT	RENT
HOUSE	HOUSE
PARLIAMENT	PARLIAMENT
RESORT	RESORT
AGENCY	AGENCY
LIUUUD	LIQUID
LIQUID	LIQUID
TENNES	JONES
MISSION	MISSION
PUB	PUB
MHEATER	THEATRE
STAABUCKS	STARBUCKS
CHERRY	CHERRY
CHERRY	CHERRY
CHINESE	CHINESE
VEGETARIAN	VEGETARIAN
STREET	STREET
STREET	STREET
CHEAES	CHERRY
CLINEST	CHINESE
PRAATIINY	VEGETARIAN
PUBI	FUJI
CRSSTES	MASSAGE
HLTRD	HARD
AAE	HARD
ROEK	ROCK
ROCIE	ROCK
LAR	CAFE
CAFE	CAFE
MEMIIIIIES	NEUMOS
NEUMOS	NEUMOS
CENTRAL	CENTRAL
GRAND	GRAND
EAGER	EAGER
IMPORTS	IMPORTS
PHIL	PHIL
CENTER	CENTER
CANVENTION	CONVENTION
GARFIELD	GARFIELD
HIGH	HIGH
SCHOOL	SCHOOL
TRAVELODGE	TRAVELODGE
GOODWILL	GOODWILL
SPEED	SPEED
CONE	ZONE
AUTO	AUTO
SUPPLY	SUPPLY
LOCKSMITH	LOCKSMITH
FARRNHHEL	FAHRENHEIT
COUMGGE	LOUNGE
CAPGGIRO	CAPOGIRO
TARGET	TARGET
ORPHEUM	ORPHEUM
THEATRE	THEATRE
REDWOD	REDWOOD
REARP	REDWOOD
ANARMMENTS	APARTMENTS
BOHEMIAN	BOHEMIAN
GRAND	GRAND
HOTEL	HOTEL
SUPER	SUPER
RECDOO	RADIO
SHACK	SHACK
CHANTRRLLE	CHANTERELLE
DONALD	DONALD
HIGH	HIGH
LINCOIN	LINCOLN
SCHOOL	SCHOOL
HOTEL	HOTEL
VERNON	VERNON
IERRSI	FIRST
FSS	FIRST
CHIOPRATIC	CHIROPRACTIC
GIULIO	GIULIO
DELL	DELI
DELL	DELI
CGARNY	GARNY
ROOTS	ROOTS
AIA	AIR
MUSEUM	MUSEUM
SPACE	SPACE
LEON	LEON
FAAZE	PLAZA
AMBRRLEA	AMERICA
INN	INN
SQUARE	SQUARE
WASHINGTON	WASHINGTON
EMBASSY	EMBASSY
SUITES	SUITES
PARKING	PARKING
CENTER	CENTER
CILY	CITY
CORNERT	CORNER
MARTINI	MARTIN
RAR	BAR
CUIZNOS	QUIZNOS
ARTS	ARTS
MODLFIED	MODIFIED
CISNEERL	BROTHERS
PROOUCIS	PRODUCTS
ZESCO	ZESCO
ZOLL	ZOLL
GOODWILL	GOODWILL
FRANKLY	FRANKLY
WINES	WINES
TEEIIDAY	HOLIDAY
RITTT	HOTEL
SNN	INN
BLILE	BIKE
KKYILLS	KYLE
SHOP	SHOP
RAST	DELI
DEI	DELI
KABOB	KABOB
KOTAYK	KOTAYK
GROCERY	GROCERY
CARITON	CARLTON
HOTEL	HOTEL
SAIYRICON	SATYRICON
ANAHEIM	ANAHEIM
BAND	BAND
INSRUMENTS	INSTRUMENTS
II	BAR
DAN	DAN
LOUIS	LOUIS
OISTA	OYSTER
CASILE	CASTLE
IUHITC	WHITE
FOOD	FOOD
JIMMY	JIMMY
STORE	STORE
HOLLYWOOD	HOLLYWOOD
POSTERS	POSTERS
PALACE	PALACE
WHITE	WHITE
WHIT	WHITE
AMEITS	AMERICA
COMFORT	COMFORT
INN	INN
SCIETOLOGY	SCIENTOLOGY
CHURCH	CHURCH
JOSE	JOSE
MUSEUM	MUSEUM
QUILTS	QUILTS
SAN	SAN
TEXTILES	TEXTILES
HOUSE	HOUSE
TEA	TEA
PAK	PAK
STRBUEKS	STARBUCKS
BURBANK	BURBANK
BURBANS	BURBANK
FLORIST	FLORIST
GIFTS	GIFTS
CHECK	CHECK
BANK	BANK
TBU	TABU
SPACE	SPACE
HEAILORO	MARLBORO
HOULIMANN	HOULIHAN
HOULIHPS	HOULIHAN
SHERATON	SHERATON
RESTAURANT	RESTAURANT
CELTARS	CELLARS
TEN	TEN
TIMES	TIMES
ACCOUTANCY	ACCOUNTANCY
RUIZTOS	QUIZNOS
SALODS	SALADS
SEIES	SUBS
JEWEL	JEWEL
OSCO	OSCO
PICKLES	PICKLES
FUA	PUB
PICKLES	PICKLES
PUB	PUB
SPAGHETTI	SPAGHETTI
WAREHOUSE	WAREHOUSE
DRPUIEED	BREWERY
PUB	PUB
SUN	SUN
MOUNTIAN	MOUNTAIN
SIMON	SIMON
GALLERY	GALLERY
STRFET	STREET
ALIS	AVIS
HIMALAYAS	HIMALAYAS
AISTAURANT	RESTAURANT
STAEET	STREET
CENTER	CENTER
UNIVERSITY	UNIVERSITY
FS	ASU
JAYS	DAYS
INN	INN
SNERAION	SHERATON
AVONTE	AVANTE
FLORIST	FLORIST
GARDENS	GARDENS
SCHOOL	SCHOOL
FORAL	FLORAL
DEIICR	DESIGN
STARBUCKS	STARBUCKS
ESEESEA	STARBUCKS
GVS	CVS
CVS	CVS
CVS	CVS
CVSS	CVS
PHARMMAYY	PHARMACY
CLI	CVS
IE	CVS
BARNSLEY	BARNSLEY
TIRA	TIRE
CAFER	CAFE
SOLEIL	SOLEIL
BAR	BAR
RESTAURANT	RESTAURANT
CENTRE	CENTRE
CIRCLE	CIRCLE
AUTOMOTIVE	AUTOMOTIVE
DLEGO	DIEGO
MUSEUM	MUSEUM
SIN	SAN
COMMON	COMMON
THREADS	THREADS
HATSU	HATSU
SUSHI	SUSHI
ART	ART
AN	ART
LAR	ART
MUSCUM	MUSEUM
AIIN	MUSEUM
TIMKEN	TIMKEN
TAAEN	TIMKEN
BBANEST	BAR
BAR	BAR
GENTRAL	CENTRAL
ICENTRALL	CENTRAL
STATION	STATION
STATIONT	STATION
PASADA	PASADA
UPROWN	UPTOWN
VILLAGE	VILLAGE
MAITTA	MASSA
TOFIL	HERTZ
COURTYARD	COURTYARD
SLMMEY	JIMMY
TOLEIG	JOHN
CHOCOLATE	CHOCOLATE
MOOSE	MOOSE
LOUNIE	LOUNGE
ATRROOLOIY	ANTHROPOLOGIE
COLONIAL	COLONIAL
RESTAURANT	RESTAURANT
CLANUING	BOOKSTORE
CITY	CITY
SA	CITY
LIGHTS	LIGHTS
AGGITS	LIGHTS
ENTERORISE	ENTERPRISE
EMBASST	EMBASSY
CHEUVRONT	CHEUVRONT
CHEUYRONT	CHEUVRONT
RESIAURANT	RESTAURANT
EAGLE	EAGLE
EAGLE	EAGLE
MEDICAL	MEDICAL
MEEDICAL	MEDICAL
AAAAA	DOOR
